9 9
WWWWWWWWW
WNNNNNNNW
WNNNNNNNW
WNNNNNBGW
WWWNNNBGW
NWWNPNBGW
NWNNNWNNW
NWNNNWWWW
NWWWWWNNN
