12 12
WWWWWWWWWWWW
WNNNNGGNNNNW
WNNWWNNWWNNW
WNNWGNNGWNNW
WNNNBBBBNNNW
WGNNBNNBNNGW
WGNNBNPBNNGW
WNNNBBBBNNNW
WNNWGNNGWNNW
WNNWWNNWWNNW
WNNNNGGNNNNW
WWWWWWWWWWWW
